111111111111111
122222222222221
121011101110121
121000000000121
121011101110121
122222222222221
121011101110121
121000000000121
121011101110121
122222222222221
111111111111111